m m m m m m m m e w
m e g g g g g g s w
m g m c m m g s s w
m g m m m g g c s w
m g g g g g g s s w
m m g m m g s s w w
m g g g m g g w w w
m g m g g m g s w w
m g c m g g g g e w
m m m m m m m m m w